NO ./textures/brick.xpm
SO ./textures/metal.xpm
WE ./textures/grass.xpm
EA ./textures/wood.xpm
S  ./textures/sprite.xpm
F  133,94,21
R  1280 720
C  0,191,255

         111111111111111111111111
        10000000001100000000000011111111111111111111111
        10110000011100000020000000000000000000000000001
        10010000000000000000000011111111111111000000001
 111111110110000011100000000000011111111111111000000001
1000000000110000011101111111111111111111111110000000001
1111011111111101110000001000111111111111111111000000001
111101111111100111010100100011111111111111111100000000111
110000001101010111022222222222222222222222222222222222221
1000000000000N0000000002100001111111111111111111111111111
12000000000000001101012210001
1100000111012101111101111000111
11110111 1012101 101111010001
11111111 1111111 111111111111